R 1000 700

NO ./textures/greystone.xpm
SO ./textures/mossy.xpm
WE ./textures/eagle.xpm
EA ./textures/redbrick.xpm

S ./textures/barrel.xpm

C 77,80,140
F 242,80,65

1 1 1 1 1 1 1 1 1 1 1 1 1 1 1 1 1 1
1 0 0 0 0 0 0 0 0 0 2 0 0 0 0 0 2 1
1 0 E 0 0 0 0 0 0 0 1 1 1 1 1 1 0 1
1 0 0 0 0 0 0 0 0 0 1 1 1 0 0 1 0 1
1 0 1 1 1 1 1 1 0 0 1 0 1 2 0 1 0 1
1 0 0 0 0 2 1 1 0 0 1 0 1 0 0 1 0 1
1 0 0 0 0 0 0 0 0 0 0 0 0 0 0 0 0 1
1 1 1 1 1 1 1 0 0 1 1 1 1 0 1 1 0 1
1 0 0 0 0 0 0 0 0 0 0 2 0 0 0 1 0 1
1 0 0 0 0 2 0 0 0 0 1 0 0 0 0 0 0 1
1 0 0 1 1 0 0 0 0 0 0 0 0 1 1 1 0 1
1 0 0 0 0 0 0 2 0 0 0 0 0 0 0 0 0 1
1 1 1 1 1 1 1 1 1 1 1 1 1 1 1 1 1 1
