R 1500 1000

NO ./textures/greystone.xpm
SO ./textures/mossy.xpm
WE ./textures/eagle.xpm
EA ./textures/redbrick.xpm

S ./textures/barrel.xpm

C 77,80,140
F 242,80,65

1111111111111111111111111111
100000000000000000000000000111
100E000000020100000000000000111
10000000000000000000000000000011
10000000011111000000000000000011
1000000001   100000000000000011
100020000111110000000000000001
100000000000000000000000000001
100000000000000000000000000001
111110000000200000000001111111
    11100000001110000001
      111100001 10000001
        1111111 11111111
