R 1500 1000

NO ./textures/greystone.xpm
SO ./textures/mossy.xpm
WE ./textures/eagle.xpm
EA ./textures/redbrick.xpm

S ./textures/barrel.xpm

C 77,80,140
F 242,80,65

1111111111111111111111111111
100000000000000000000000000111
100E000000020000000000000000111
10000000000000000002000000000011
10000000011111000000000000000001
1000000001   10000000001111111111
100020000111110000000001
100000000000000000000001
100000000000000000000001
1111100000002000000000011
    11100000001110000001
      111100001 10000001
        1111111 11111111
