R 1000000 1000000

NO ./textures/greystone.xpm
SO ./textures/mossy.xpm
WE ./textures/eagle.xpm
EA ./textures/redbrick.xpm

S ./textures/barrel.xpm

C 77,80,45
F 242,80,65

        1111111111111111111111111
        1000000000110000000000001
        1011000001110000002000001
        1001000000000000000000001
111111111011000001110000000000001
100000000011000001110111010001111
111101111111110111000000000011
11110111111111011101111110001
110000001101010111001   10001
10002000N000000011001   10001
100000000000000011011   10001
1100000111010101111101111000111
11110111 1110101 101111010001
11111111 1111111 111111111111